r
*********
*##*#*##*
*#*****#*
***###***
*#*****#*
***#*#***