r
*********
*#*****#*
*#*****#*
***###***
*#*****#*
*#*###*#*