r
*********
*##*#*##*
*#*****#*
*#*###*#*
*#*****#*
*********