r
#########
*********
*********
***###***
****#****
****#****