r
***#*****
****#**#*
**#****#*
**#####*#
**#***#**
****#****