r
*********
*##*#*##*
*******#*
*#*###*#*
**#****#*
**#******