r
****#****
*#*#*#*#*
*********
*#*###*#*
*********
*#*#*#*#*