r
**#******
*#***#*#*
***#**#**
*#*###*#*
**#******
*#*****#*