r
*********
*#*#*#*#*
**#***#**
*#*###*#*
*********
*#**#**#*