r
*********
*#*#*#*#*
**#***#**
*#*###*#*
*#*******
*#*****#*