r
****#****
*#*#*#*#*
******#**
*#*###*#*
*********
*#**#**#*