r
****#****
*#*#*#*#*
*********
*#*###*#*
**#****#*
*#*****#*