r
****#****
*#*#*#*#*
*#*****#*
*#*###*#*
*********
*#*****#*