r
****#****
*#*#*#*#*
*********
*#*###*#*
****#****
*#**#**#*