r
##***#**#
#**#*#***
**#*****#
***###***
##*******
*********