r
#*#*#****
***#*#**#
*#*******
#**###**#
**#******
***#*****