r
****#****
*********
*#*#*#*#*
#**###**#
*#*****#*
***#*#***