r
***#*****
**#*#*#**
*#*****#*
***###**#
*#*****#*
***#*#***