r
***#*****
****##***
*##***#**
*#*####*#
*#*******
***#*****