r
*********
*#*#*#*#*
**#***#**
#*#####**
#**#*****
*********