r
*********
*#*#*#*#*
**#***#**
*#*###*#*
****#****
*#*****#*