r
***#*****
***#*#***
*##***#**
*#*####*#
*#*******
***#*****