r
*********
***#*#***
*##***#**
*#*####*#
*#**#****
***#*****