r
*********
*#*#*#***
**#***#**
*#*####*#
*#**#****
***#*****