r
*****#***
*#*#*#*#*
**#******
*#*####*#
*#*******
***#*****