r
*****#***
*#*#*#*#*
**#***#**
*#*###**#
*#*******
***#*****