r
****#****
*#*#*#*#*
******#**
*#*###**#
*#*******
***#*#***