r
****#****
*#*#*#*#*
**#*****#
*#*###*#*
*********
*#*****#*